Tsunami	KEYWORD1
tsunami	KEYWORD1
setOutputMode	KEYWORD2
setFrequency	KEYWORD2
reset	KEYWORD2
sleep	KEYWORD2
selectFrequency	KEYWORD2
selectPhase	KEYWORD2
setAmplitude	KEYWORD2
measurePeakVoltage	KEYWORD2
measureMeanVoltage	KEYWORD2
measureCurrentVoltage	KEYWORD2
measureFrequency	KEYWORD2
measureAverageFrequency	KEYWORD2
measurePhase	KEYWORD2
setOffset	KEYWORD2
enableSignOutput	KEYWORD2
disableSignOutput	KEYWORD2
enableAuxiliaryFiltering	KEYWORD2
disableAuxiliaryFiltering	KEYWORD2
setCalibrationData	KEYWORD2
getCalibrationData	KEYWORD2
useCalibrationData	KEYWORD2
OUTPUT_MODE_SINE	LITERAL1
OUTPUT_MODE_TRIANGLE	LITERAL1
CAL_DATA_OFFSET	LITERAL1
CAL_DATA_AMPLITUDE	LITERAL1
CAL_DATA_MEAN_VALUE	LITERAL1
CAL_DATA_PEAK_VALUE	LITERAL1
CAL_DATA_CURRENT_VALUE	LITERAL1
CAL_DATA_ALL	LITERAL1
CAL_DATA_NONE	LITERAL1
